
NO /nfs/homes/oelboukh/Desktop/thanks/cub3d/cub_3d/cub3d/texters/east.xpm
SO /nfs/homes/oelboukh/Desktop/thanks/cub3d/cub_3d/cub3d/texters/east.xpm
WE /nfs/homes/oelboukh/Desktop/thanks/cub3d/cub_3d/cub3d/texters/old-vintage-window_1339-57695.xpm
EA /nfs/homes/oelboukh/Desktop/thanks/cub3d/cub_3d/cub3d/texters/rock-wall-kevin-croitz.xpm

F 135,206,235
C 139,69,19

11111111111111111
100000E0001100001
10110000000100001
10010000000100001
10010000000100001
10010000000100001
11111111111111111